6,8
1,1,1,1,1,1
1,3,0,0,4,1
1,5,0,0,6,1
1,7,7,8,8,1
1,9,9,10,10,1
1,0,0,0,0,1
1,0,2,2,0,1
1,1,2,2,1,1